Query_Name	Query
Total_NIH	("Clinical Trial, Phase II" [Publication Type] OR "Clinical Trial, Phase III" [Publication Type]) AND (NIH[gr] OR "research support, n i h, extramural"[Publication Type] OR "research support, n i h, intramural"[Publication Type])
Total_notNIH	("Clinical Trial, Phase II" [Publication Type] OR "Clinical Trial, Phase III" [Publication Type]) NOT (NIH[gr] OR "research support, n i h, extramural"[Publication Type] OR "research support, n i h, intramural"[Publication Type])
TopGBD_NIH	("Heart Diseases"[Mesh] OR "Lung Neoplasms"[Mesh] OR "Substance-Related Disorders"[Mesh] OR "Pulmonary Disease, Chronic Obstructive"[Mesh] OR "Stroke"[Mesh] OR "Alzheimer Disease"[Mesh] OR "Self-Injurious Behavior"[Mesh] OR "Liver Cirrhosis"[Mesh] OR "Colorectal Neoplasms"[Mesh]) AND ("Clinical Trial, Phase II" [Publication Type] OR "Clinical Trial, Phase III" [Publication Type]) AND (NIH[gr] OR "research support, n i h, extramural"[Publication Type] OR "research support, n i h, intramural"[Publication Type])
TopGBD_notNIH	("Heart Diseases"[Mesh] OR "Lung Neoplasms"[Mesh] OR "Substance-Related Disorders"[Mesh] OR "Pulmonary Disease, Chronic Obstructive"[Mesh] OR "Stroke"[Mesh] OR "Alzheimer Disease"[Mesh] OR "Self-Injurious Behavior"[Mesh] OR "Liver Cirrhosis"[Mesh] OR "Colorectal Neoplasms"[Mesh]) AND ("Clinical Trial, Phase II" [Publication Type] OR "Clinical Trial, Phase III" [Publication Type]) NOT (NIH[gr] OR "research support, n i h, extramural"[Publication Type] OR "research support, n i h, intramural"[Publication Type])
Heart_NIH	("Heart Diseases"[Mesh]) AND ("Clinical Trial, Phase II" [Publication Type] OR "Clinical Trial, Phase III" [Publication Type]) AND (NIH[gr] OR "research support, n i h, extramural"[Publication Type] OR "research support, n i h, intramural"[Publication Type])
Heart_notNIH	("Heart Diseases"[Mesh]) AND ("Clinical Trial, Phase II" [Publication Type] OR "Clinical Trial, Phase III" [Publication Type]) NOT (NIH[gr] OR "research support, n i h, extramural"[Publication Type] OR "research support, n i h, intramural"[Publication Type])
Lung_NIH	("Lung Neoplasms"[Mesh]) AND ("Clinical Trial, Phase II" [Publication Type] OR "Clinical Trial, Phase III" [Publication Type]) AND (NIH[gr] OR "research support, n i h, extramural"[Publication Type] OR "research support, n i h, intramural"[Publication Type])
Lung_notNIH	("Lung Neoplasms"[Mesh]) AND ("Clinical Trial, Phase II" [Publication Type] OR "Clinical Trial, Phase III" [Publication Type]) NOT (NIH[gr] OR "research support, n i h, extramural"[Publication Type] OR "research support, n i h, intramural"[Publication Type])
Drugs_NIH	("Substance-Related Disorders"[Mesh]) AND ("Clinical Trial, Phase II" [Publication Type] OR "Clinical Trial, Phase III" [Publication Type]) AND (NIH[gr] OR "research support, n i h, extramural"[Publication Type] OR "research support, n i h, intramural"[Publication Type])
Drugs_notNIH	("Substance-Related Disorders"[Mesh]) AND ("Clinical Trial, Phase II" [Publication Type] OR "Clinical Trial, Phase III" [Publication Type]) NOT (NIH[gr] OR "research support, n i h, extramural"[Publication Type] OR "research support, n i h, intramural"[Publication Type])
COPD_NIH	("Pulmonary Disease, Chronic Obstructive"[Mesh]) AND ("Clinical Trial, Phase II" [Publication Type] OR "Clinical Trial, Phase III" [Publication Type]) AND (NIH[gr] OR "research support, n i h, extramural"[Publication Type] OR "research support, n i h, intramural"[Publication Type])
COPD_notNIH	("Pulmonary Disease, Chronic Obstructive"[Mesh]) AND ("Clinical Trial, Phase II" [Publication Type] OR "Clinical Trial, Phase III" [Publication Type]) NOT (NIH[gr] OR "research support, n i h, extramural"[Publication Type] OR "research support, n i h, intramural"[Publication Type])
Stroke_NIH	("Stroke"[Mesh]) AND ("Clinical Trial, Phase II" [Publication Type] OR "Clinical Trial, Phase III" [Publication Type]) AND (NIH[gr] OR "research support, n i h, extramural"[Publication Type] OR "research support, n i h, intramural"[Publication Type])
Stroke_notNIH	("Stroke"[Mesh]) AND ("Clinical Trial, Phase II" [Publication Type] OR "Clinical Trial, Phase III" [Publication Type]) NOT (NIH[gr] OR "research support, n i h, extramural"[Publication Type] OR "research support, n i h, intramural"[Publication Type])
Alz_NIH	("Alzheimer Disease"[Mesh]) AND ("Clinical Trial, Phase II" [Publication Type] OR "Clinical Trial, Phase III" [Publication Type]) AND (NIH[gr] OR "research support, n i h, extramural"[Publication Type] OR "research support, n i h, intramural"[Publication Type])
Alz_notNIH	("Alzheimer Disease"[Mesh]) AND ("Clinical Trial, Phase II" [Publication Type] OR "Clinical Trial, Phase III" [Publication Type]) NOT (NIH[gr] OR "research support, n i h, extramural"[Publication Type] OR "research support, n i h, intramural"[Publication Type])
SelfHarm_NIH	("Self-Injurious Behavior"[Mesh]) AND ("Clinical Trial, Phase II" [Publication Type] OR "Clinical Trial, Phase III" [Publication Type]) AND (NIH[gr] OR "research support, n i h, extramural"[Publication Type] OR "research support, n i h, intramural"[Publication Type])
SelfHarm_notNIH	("Self-Injurious Behavior"[Mesh]) AND ("Clinical Trial, Phase II" [Publication Type] OR "Clinical Trial, Phase III" [Publication Type]) NOT (NIH[gr] OR "research support, n i h, extramural"[Publication Type] OR "research support, n i h, intramural"[Publication Type])
Cirrhosis_NIH	("Liver Cirrhosis"[Mesh]) AND ("Clinical Trial, Phase II" [Publication Type] OR "Clinical Trial, Phase III" [Publication Type]) AND (NIH[gr] OR "research support, n i h, extramural"[Publication Type] OR "research support, n i h, intramural"[Publication Type])
Cirrhosis_notNIH	("Liver Cirrhosis"[Mesh]) AND ("Clinical Trial, Phase II" [Publication Type] OR "Clinical Trial, Phase III" [Publication Type]) NOT (NIH[gr] OR "research support, n i h, extramural"[Publication Type] OR "research support, n i h, intramural"[Publication Type])
ColoRect_NIH	("Colorectal Neoplasms"[Mesh]) AND ("Clinical Trial, Phase II" [Publication Type] OR "Clinical Trial, Phase III" [Publication Type]) AND (NIH[gr] OR "research support, n i h, extramural"[Publication Type] OR "research support, n i h, intramural"[Publication Type])
ColoRect_notNIH	("Colorectal Neoplasms"[Mesh]) AND ("Clinical Trial, Phase II" [Publication Type] OR "Clinical Trial, Phase III" [Publication Type]) NOT (NIH[gr] OR "research support, n i h, extramural"[Publication Type] OR "research support, n i h, intramural"[Publication Type])